11111111111111111111
100000C01000000000P1
100000001C0000000001
10000111100000000001
10000000000000000001
100000000000000000C1
10000011111111111111
10000000000000000001
1C000E00C00000000001
11111111111111111111
